#################
#S#       #F    #
# ####### ##### #
#           # # #
##### ### # #   #
#   # #   #     #
#   # # #########
#   # # #       #
#               #
#################